0000000000000000000000000000000000000000
0000000000000000000000000000000000000000
0000000506080000000005060606060708000000
0000002236250000000527243515231525000000
0000002224160000052741153538153616000000
0000001435260706273624152424242031000000
0000001435232323363915414120343100000000
0000001441421515422034333331000000000000
0000002215232315203100000000000000000000
0000002833323233310000000000000000000000
0000000000000000000000000000000000000000
0000000000000000000000000000000000000000
