0000000000000000000000000000000000000000
0000000000000000000000000000000000000000
0000050607080000000000000507060607080000
0000222315260800000000052741234237250000
0000222339351600000000144023391515160000
0000283334323100000000283033333421250000
0000000000000000000000000000000028310000
0000000000000000000000000000000000000000
0000000000000143020000000000000000000000
0000000000000944474343020000000000000000
0000000000001748120344110000000000000000
0000000000000017041813190000000000000000
