0000000000000000000000000000000000000000
0000000000000000000000000000000000000000
0000000507080005080000000506060706080000
0000052715260727250000002240423923250000
0000143715244141160000002821233720310000
0000221542244120310000000022152316000000
0000224236241525000000000014152326080000
0000223524392031000000000527244040160000
0000223924203100000000052724412415160000
0000283432310000000000283432333232310000
0000000000000000000000000000000000000000
0000000000000000000000000000000000000000
